0 0 1 1 1 1 1 1 1 0
0 0 1 0 0 0 0 0 1 0
0 0 1 0 4 0 2 0 1 0
1 1 1 1 1 0 1 0 1 0
1 0 4 0 0 0 0 0 1 0
1 0 0 1 4 1 1 0 1 1
1 3 3 4 0 0 1 0 0 1
1 3 3 0 0 0 0 0 0 1
1 1 1 1 1 1 1 1 1 1