1 1 1 1 1 1
1 3 3 7 3 1
1 3 4 0 0 1
1 1 0 4 0 1
1 1 4 0 1 0
1 2 4 0 1 0
1 1 0 0 1 0
0 1 1 1 1 0